40x40
6  6  6  6  6  6  6  6  6  6  6  6  6  6  6  6  6  7  7  7  7  7  7  7  7  7  7  7  7  7  7  7  7  6  6  6  6  6  6  6
6  0  0  0  0  0  0  0  0  0  0  0  0  0  0  0  6  7  3  3  7  3  3  3  3  3  3  3  3  7  3  3  7  6  6  6  6  6  6  6
6  0  0  0  0  0  0  0  0  0  0  0  0  0  0  0  6  7  3  3  7  3  3  3  3  3  3  3  3  7  3  3  7  6  6  6  6  6  6  6
6  0  0  0  0  0  0  0  0  0  0  0  0  0  0  0  6  7  3  3  7  3  3  7  3  3  7  3  3  7  3  3  7  6  6  6  6  6  6  6
6  0  0 19  0  0  0 20  0  0  0  0  0  0  0  0  6  7  3  3  7  3  3  7  3  3  7  3  3  7  3  3  7  6  6  6  6  6  6  6
6  0  0  0  0  0  0  0  0  0  0  0  0  0  0  0  6  7  3  3  7  3  3  7  3  3  7  3  3  3  3  3  7  6  6  6  6  6  6  6
6  0  0  0  0  0  0  0  0  0  0  0  0  0  0  0  6  7  3  3  7  3  3  7  3  3  7  3  3  3  3  3  7  6  6  6  6  6  6  6
6  0  0  0  0  0  0  0  0  0  0  0  0  0  0  0  6  7  3  3  3  3  3  7  3  3  7  3  3  7  3  3  7  6  6  6  6  6  6  6
6  0  0 18  0  0  0  0  0  0  0  0  0  0  0  0  6  7  3  3  3  3  3  7  3  3  7  3  3  7  3  3  7  6  6  0  0  0  6  6
6  0  0  0  0  0  0  0  0  0  0  0  0  0  0  0  6  7  7  7  7  3  3  7  7  7  7  3  3  7  3  3  7  6  0  0  0  0  0  6
6  0  0  0  0  0  0  0  0  0  0  0  0  0  0  0  2  3  3  3  3  3  3  7  3  3  3  3  3  7  3  3  3  2  0  0  0  0  0  6
6  0  0  0  0  0  0  0  0  0  0  0  0  0  0  0  6  7  3  3  3  3  3  7  3  3  3  3  3  7  3  3  7  6  0  0  0  0  0  6
6  0  0 17  0  0  0  0  0  0  0  0  0  0  0  0  6  7  7  7  7  7  7  7  7  7  7  7  7  7  7  7  7  6  6  0  0  0  6  6
6  0  0  0  0  0  0  0  0  0  0  0  0  0  0  0  6  6  6  6  6  6  6  6  6  6  6  6  6  6  6  6  6  6  6  0  0  0  6  6
6  0  0  0  0  0  0  0  0  0  0  0  0  0  0  0  6  0  0  0  0  0  0  0  0  0  0  0  0  0  0  0  0  0  6  0  0  0  6  6
6  0  0  0  0  0  0  0  0  0  0  0  0  0  0  0  6  0  0  0  0  0  0  0  0  0  0  0  0  0  0  0  0  0  6  0  0  0  6  6
6  0  0 16  0  0  0  0  0  0  0  0  0  0  0  0  6  0  0  6  0  0  6  0  0  6  0  0  6  0  0  6  0  0  6  0  0  0  6  6
6  0  0  0  0  0  0  0  0  0  0  0  0  0  0  0  6  0  0  0  0  0  0  0  0  0  0  0  0  0  0  0  0  0  6  6  2  6  6  6
6  0  0  0  0  0  0  0  0  0  0  0  0  0  0  0  2  0  0  0  0  0  0  0  0  0  0  0  0  0  0  0  0  0  6  0  0  0  6  6
6  0  0  0  0  0  0  0  0  0  0  0  0  0  0  0  6  0  0  6  0  0  6  0  0  6  0  0  6  0  0  6  0  0  2  0  0  1  6  6
6  0  0 15  0  0  0  0  0  0  0  0  0  0  0  0  6  0  0  0  0  0  0  0  0  0  0  0  0  0  0  0  0  0  6  0  0  0  6  6
6  0  0  0  0  0  0  0  0  0  0  0  0  0  0  0  6  0  0  0  0  0  0  0  0  0  0  0  0  0  0  0  0  0  6  6  2  6  6  6
6  0  0  0  0  0  0  0  0  0  0  0  0  0  0  0  6  0  0  6  0  0  6  0  0  6  0  0  6  0  0  6  0  0  6  0  0  0  6  6
6  0  0  0  0  0  0  0  0  0  0  0  0  0  0  0  6  0  0  0  0  0  0  0  0  0  0  0  0  0  0  0  0  0  6  0  0  0  6  6
6  0  0 14  0  0  0  0  0  0  0  0  0  0  0  0  6  0  0  0  0  0  0  0  0  0  0  0  0  0  0  0  0  0  6  0  0  0  6  6
6  0  0  0  0  0  0  0  0  0  0  0  0  0  0  0  6  6  6  6  6  6  6  6  6  6  6  6  6  6  6  6  6  6  6  0  0  0  6  6
6  0  0  0  0  0  0  0  0  0  0  0  0  0  0  0  6  8  8  8  9 10  8  9 10  8  9 10  8  9 10  8  8  6  0  0  0  0  0  6
6  0  0  0  0  0  0  0  0  0  0  0  0  0  0  0  6  8  0  0  0  0  0  0  0  0  0  0  0  0  0  0  0  2  0  0  0  0  0  6
6  0  0 13  0  0  0  0  0  0  0  0  0  0  0  0  2  0  0  0  0  0  0  0  0  0  0  0  0  0  0  0  8  6  0  0  0  0  0  6
6  0  0  0  0  0  0  0  0  0  0  0  0  0  0  0  6  8  0  0 11 11  0  0 11 11  0  0 11 11  0  0  8  6  6  0  0  0  6  6
6  0  0  0  0  0  0  0  0  0  0  0  0  0  0  0  6  9  0  0 11 11  0  0 11 11  0  0 11 11  0  0  9  6  6  6  6  6  6  6
6  0  0  0  0  0  0  0  0  0  0  0  0  0  0  0  6 10  0  0  0  0  0  0  0  0  0  0  0  0  0  0 10  6  6  6  6  6  6  6
6  0  0 12  0  0  0 21  0  0  0  0  0  0  0  0  6  8  0  0  0  0  0  0  0  0  0  0  0  0  0  0  8  6  6  6  6  6  6  6
6  0  0  0  0  0  0  0  0  0  0  0  0  0  0  0  6  9  0  0 11 11  0  0 11 11  0  0 11 11  0  0  9  6  6  6  6  6  6  6
6  0  0  0  0  0  0  0  0  0  0  0  0  0  0  0  6 10  0  0 11 11  0  0 11 11  0  0 11 11  0  0 10  6  6  6  6  6  6  6
6  0  0  0  0  0  0  0  0  0  0  0  0  0  0  0  6  8  0  0  0  0  0  0  0  0  0  0  0  0  0  0  8  6  6  6  6  6  6  6
6  0  0  0  0  0  0  0  0  0  0  0  0  0  0  0  6  8  0  0  0  0  0  0  0  0  0  0  0  0  0  0  8  6  6  6  6  6  6  6
6  0  0  0  0  0  0  0  0  0  0  0  0  0  0  0  6  8  8  8  9 10  8  9 10  8  9 10  8  9 10  8  8  6  6  6  6  6  6  6
6  6  6  6  6  6  6  6  6  6  6  6  6  6  6  6  6  6  6  6  6  6  6  6  6  6  6  6  6  6  6  6  6  6  6  6  6  6  6  6
6  6  6  6  6  6  6  6  6  6  6  6  6  6  6  6  6  6  6  6  6  6  6  6  6  6  6  6  6  6  6  6  6  6  6  6  6  6  6  6
